2222222222
2222222222
2222222222
2222222222
2222222222
2222222222
2222222222
2222222222
2222232222
2222222222

1111111111
1000000001
1011114101
1011110111
1010000111
1010111111
1010400011
1010111011
1010031011
1011111011

1111111111
1000000001
1011114101
1011110131
1010000111
1010111111
1010400011
1010111011
1010031011
1011111011
